.......X...
XXXXXX.XXX.
.....X.....
.X.XXXXXXX.
.X.........
